NO ./textures/grey.xpm
SO ./textures/blue.xpm
EA ./textures/brick.xpm
WE ./textures/wood.xpm

F 136, 187, 102
C 153, 204, 221

111111111
1N1
111
