NO ./textures/grey.xpm
SO ./textures/blue.xpm
EA ./textures/grey.xpm
WE ./textures/blue.xpm

F 100, 100, 0
C 222, 0, 222

1111111111
1000000001
1000000001
100N000011
1000000001
1000000001
1000000001
1000000001
1000000001
1000000001
1111111111