F 100, 100, 0

NO ./textures/grey.xpm
SO ./textures/blue.xpm
EA ./textures/grey.xpm
C 222, 0, 222
WE ./textures/blue.xpm



 11111111  11
  10000011111
110101101
1100001011
1111111011
1010101011
10N0010001
1111011011
1000000001
1111111111