NO ./textures/grey.xpm
SO ./textures/blue.xpm
EA ./textures/grey.xpm
WE ./textures/blue.xpm

F 1, 0, 0
C 222, 222, 222

1111111111
1000000001
1000000011
1000000001
1000N00001
1000000001
1111111111