NO ./textures/grey.xpm
SO ./textures/blue.xpm
EA ./textures/brick.xpm
WE ./textures/wood.xpm

F 136, 187, 102
C 153, 204, 221

1 1111111
1 1000001
101011001
100N00001
100000001
111111111

