NO ./textures/grey.xpm
SO ./textures/blue.xpm
EA ./textures/brick.xpm
WE ./textures/wood.xpm

F 136, 187, 102
C 153, 204, 221

11111
10001
10001
10N01
11111