NO ./kek.cub
SO ./kek.cub
EA ./kek.cub
WE ./kek.cub

F 1, 0, 0
C 222, 222, 222

111111
1011001
111E011
1000011
11111