NO ./kek.cub
SO ./kek.cub
EA ./kek.cub
WE ./kek.cub

F 1, 0, 0
C 222, 222, 222
11110000
01111111
1000N001
11111111
