NO ./kek.cub
SO ./kek.cub
EA ./kek.cub
WE ./kek.cub

F 1, 0, 0
C 222, 222, 222
11111111
11111111
100 0001
1000N001
10000001
11111111
