NO ./kek.cub
SO ./kek.cub
EA ./kek.cub
WE ./kek.cub

F 1, 0, 0
C 222, 222, 222

1111111
1000001
100N011
1000001
1111111